11111211211111111111
10000000000000000001
20000002111111000001
10000000001111110001
10000000000000000001
10033445511110000001
20010000000010000001
10010000000010000001
10010000000010000001
10010000000000000001
10011111110000000001
10000000000000000001
10001111111100000001
10000000000001000001
10000000000001000001
10001000000001000001
10001111100001000001
10001000000000000001
10000000000000000001
11111111111111111111